Player's Handbook: راهنمای بازیکنان
Dungeons and Dragons: دیوها و دخمه‌ها
DnD, D&D: د.و.د.
Casting a spell: طلسم‌خوانی
Spellcaster: طلسم‌خوان
Variant: حالت دیگر
Sleight of Hand: تردستی
Perception: ادراک
Intimidation: ارعاب
Animal Handling: رام کردن حیوانات
Performance: نمایش
Athletics: ورزشکاری
Acrobatics: آکروباتیک
Stealth: مخفی‌کاری
Arcana: علوم خفیه
Armor Class: درجه زره
Difficulty Class: درجه سختی
Damage: آسیب
Advantage: دست بالا
Disadvantage: دست پایین
Gamemaster: بازی‌گردان
Barbarian: وحشی
Bard: رامشگر
Cleric: راهب
Druid: کاهن
Fighter: مبارز
Paladin: پهلوان
Rogue: یاغی
Sorcerer: ساحر
Warlock: جنگیر
Wizard: جادوگر
Monk: مرتاض
Ranger: تکاور
Elf: الف
Dwarf: دورف
Halfling: هافلینگ
Tiefling: تیفلینگ
Dragonborn: اژدهازاد
Half-elf: نیم‌الف
Half-orc: نیم‌اورک
Passive: گذرا
Insight: بینش
Athletics: ورزشکاری
Persuasion: ترغیب
Investigation: کندوکاو
Undead: نامرده
Feat: فن
Inspiration: تشویق
Skill check: تاس سنجش
Background: پیشینه
Spell: طلسم
Cantrip: ورد
Ritual: مراسم
Class: کلاس
Alignment: جبهه اخلاقی
Action: فعالیت
Reaction: واکنش
Slot: سهمیه
Feature: ویژگی
Creature: موجود
Melee: ضربی
Ranged: دوربرد
Ability Score: امتیاز توانایی
Darkvision: دید در شب
Longbow: کمان بلند
Shortbow: کمان کوتاه
Longsword: شمشیر بلند
Shortsword: شمشیر کوتاه
Crossbow: زوبین
Dart: پیکان
Javelin: ناوک
Rapier: راپیر
Scimitar: قمه
Abjuration: جادوی ابطال,
Conjuration: جادوی احضار,
Divination: جادوی الهام,
Enchantment: جادوی افسون,
Evocation: جادوی ایجاد,
Illusion: جادوی توهم,
Necromancy: جادوی اموات,
Transmutation: جادوی تبدیل
spell: طلسم
creature: موجود
level: سطح
damage: آسیب
action: فعالیت
feet: فوت
target: هدف
attack: حمله
use (numbers of): سهمیه
ability: توانایی
cast (a spell): خواندن طلسم
saving throw: تاس نجات
points: امتیازات
weapon: سلاح
magic: جادو
range (of a weapon or spell): بُرد
components: اجزاء
duration: مدت
creatures: موجودات
bonus: عدد کمکی، کمکی، اضافی
turn(s): نوبت
character: شخصیت
slot: سهمیه
armor: زره
gain a level: ارتقای سطح
effect: اثر
light: نور، سبک
area: ناحیه
class: کلاس
score: امتیاز
wisdom: درایت
skill check: تاس سنجش
proficiency: قابلیت
modifier: عدد اصلاحی
strength: قدرت
concentration: تمرکز
dexterity: چابکی
speed: سرعت
feature: ویژگی
touch: لمس
reach: در دسترس بودن
god: ایزد
constitution: بنیه
advantage: دست بالا
fire damage: آسیب آتشین
nature: طبیعت
ft: فوت
melee: ضربی
spellcasting: طلسم‌خوانی
increases: افزایش
weapons: اسلحه
space: فضا
planes: پهنه
charisma: جذبه
intelligence: هوش
people: مردمان
illusion: توهم
dc: درجه سختی
failed: ناموفق
spend: مصرف، خرج
disadvantage: دست پایین
movement: حرکت
rolls: تاس‌ها
successful: موفق
combat: نبرد
gods: ایزدان
die: تاس
common (language): زبان رایج
knowledge: علم، دانش
beast: جانور
wizard: جادوگر
equipment: تجهیزات
instantaneous: درجا
succeed: موفق شدن
human: انسان
undead: نامرده
cleric: راهب
adventurers: ماجراجویان
war: جنگ
extra: اضافی
divine: الهی
arcane: خفیه
sphere: کره
evocation: جادوی ایجاد
background: پیشینه
tools: ابزار
channel: کانال
speak: صحبت
elemental: عنصرینه
druid: کاهن
dice: تاس
elf: الف‌
skill: مهارت‌
energy: انرژی
material: مادی
paladin: پهلوان
alignment: جبهه‌ی اخلاقی
conjuration: احضار
transmutation: تبدیل
medium: متوسط
poison: سم
poison damage: آسیب سمی
reaction: واکنش
ki: نیروی کی
statistics: اعداد
terrain: نوع زمین
eldritch knight: سلحشور سحار
divinity: الوهیت
lightning damage: آسیب آذرخشی
regain: بازیابی
perception: ادراک
oath: سوگند
warlock: جنگیر
senses: حواس
ranged: دوربرد
charmed: افسون‌شده
challenge rating: درجه چالش
shield: سپر
known: دانسته
piercing: سوراخی
focus: کانون
martial: رزمی
resistance: مقاومت
dwarf: دورف
bard: رامشگر
domain: حیطه
race: نژاد
physical: فیزیکی
traits: ویژگی
person: شخص
abjuration: ابطال
adventuring: ماجراجویی
school: مکتب
d&d: د.و.د.
cantrip: ورد
goddess: ایزدبانو
personality: ویژگی‌های شخصیتی
fey: پری
divination: جادوی الهام
enchantment: جادوی افسون
ancient: باستانی
fighter: مبارز
prone: نقش زمین
proficiencies: قابلیت‌ها
animal: حیوان
control: کنترل
bludgeoning: کوبشی
frightened: هراسان
healing: شفا
dungeon: دخمه
deity: ایزد
aura: هاله
ranger: تکاور
radius: شعاع
round: راند
inspiration: تشویق
passive: گذرا
sorcerer: ساحر
tiny: ریز
ammunition: مهمات
monster: هیولا
holy: مقدس
expend: خرج، مصرف
conditions: حالت‌ها
ritual: مراسم
stealth: مخفی‌کاری
protection: محافظت
monk: مرتاض
halfling: هافلینگ
ac: درجه زره
slashing: آسیب برشی
spellbook: طلسم‌نامه
invocations: توسل، نیایش
condition: حالت
glyph: گلیف
adventure: ماجراجویی
call: فراخوان
archetype: کهن‌الگو
gnome: گنوم
kit: ابزار کار
guild: اتحادیه
companions: همراهان
dragonborn: اژدهازاد
ethereal: اثیری
friendly: خودی
trickery: نیرنگ
incapacitated: ناتوان
dex: چابکی
multiverse: جهانگان
acid damage: آسیب اسیدی
force damage: آسیب نیرویی
necromancy: جادوی اموات
forgotten realms: قلمروهای فراموش‌شده
tradition: سنت، رسوم
rage: خشم
storm: توفان
plant: گیاه
blinded: نابینا
perform: اجرای نمایش
enemy: دشمن
lore: افسانه
patron: حامی
d20: تاس۲۰
clan: قبیله
darkvision: دید در شب
sorcery: سحروجادو
halfling: هافلینگ
rogue: یاغی
barbarian: وحشی
hit points: امتیاز جان
hit dice: تاس جان
portal: درگاه
task: کار
benefits: مزایا
proficient: قابل
immune: مصون
fiend: دیو
opportunity attack: حمله فرصت‌طلبانه
minor: صغیر
radiant damage: آسیب نورانی
thunder damage: آسیب تندری
drow: دراو
smite: هلاکت
orc: اورک
critical: حاد
spell attack: حمله با طلسم
weapon attack: حمله با سلاح
underdark: سیاه‌ژرف
finesse: دقیق
paladin: پهلوان
monk: مرتاض 
